30 11
####################S#########
##################           #
##################           E
##################           #
##################           #
##################           #
##################           #
##################           #
##################           #
############                 #
##############################