22 19
###################S##
#                    #
#                    #
#                    #
#                    #
#                    #
#######        #######
#######        #######
#######        #######
#######        #######
#######        #######
#######        #######
#######        #######
#                    #
#                    #
#                    #
#                    #
#                    #
##E###################