20 6
####S###############
#         #        #
#         #        #
#         #        #
#         #        #
################E###
