49 9
#################################################
#                        #           #      #   #
#         #              #           ###  # # # #
#         #              #     #       #  # # # #
E         #                    #       #  # # # S
#         #                    #          # # # #
#                              #          # # # #
#                              #          #   # #
#################################################
