36 12
####################################
#                                  #
#  ##  ##########  ##########  ##  #
#  ##  ##########  ##########  ##  #
#  ##  #####            #####  ##  #
E  ##           ####           ##  S
#  ##           ####           ##  #
#  ##  #####            #####  ##  #
#  ##  ##########  ##########  ##  #
#  ##  ##########  ##########  ##  #
#                                  #
####################################
